NO ./textures/north_texture.xpm
SO ./textures/south_texture.xpm
WE ./textures/west_texture.xpm
EA ./textures/east_texture.xpm

C 35,19,73
F 15,6,40

111111111111111
111111000111111
111110000011111
1111A00N0001111
111000000000111
110000DAP000011
100001111100001
110000111000011
111000010000111
111100000001111
111110000011111
111111000111111
111111111111111

